111111111111111
1XE00000000X001
10000010000C001
100C00E000CP001
10000000000C001
1X000010000X0E1
111111111111111
