11111111111111111
100E0000000E000C1
1P000001111000001
100000CX000000001
11111111111111111
